    #####
    #   #
    #$  #
  ###  $##
  #  $ $ #
### # ## #   ######
#   # ## #####  ..#
#    $          ..#
##### ### #@##   .#
    #     #########
    #######