Tests best fit to HeuristicsI of MagIA

##########
#@   #.$ #
#  $$   .#
#    #$ .#
#    #  .#
##########
; 9


    #####
    #   #
    #$  #
  ###  $##
  #  $ $ #
### # ## #   ######
#   # ## #####  ..#
#    $          ..#
##### ### #@##   .#
    #     #########
    #######
Title: Level 1

'The Dungeon'
    ######               ####
#####*#  #################  ##
#   ###                      #
#        ########  ####  ##  #
### ####     #  ####  ####  ##
#*# # .# # # #     #     #   #
#*# #  #     # ##  # ##  ##  #
###    ### ###  # ##  # ##  ##
 #   # #*#      #     # #    #
 #   # ###  #####  #### #    #
 #####   #####  ####### ######
 #   # # #**#               #
## # #   #**#  #######  ##  #
#    #########  #    ##### ###
# #             # $        #*#
#   #########  ### @#####  #*#
#####       #### ####   ######

'The Maze'
 ############################
 #                          #
 # ######################## #
 # #                      # #
 # # #################### # #
 # # #                  # # #
 # # # ################ # # #
 # # # #              # # # #
 # # # # ############ # # # #
 # # # # #            # # # #
 # # # # # ############ # # #
 # # # # #              # # #
 # # # # ################ # #
 # # # #                  # #
##$# # #################### #
#. @ #                      #
#############################



